WWWWWWWWWWWWWWWWWWWWWWWWWWWWWWWWWWWWWWWWWWWWWWWWWWWWWWWWWWWWWWWW
W             WW W       W    WWWWW #        WW  W    WW       W
W       WW#WW WW   WW WW   WW  WW   WWW WW W W                 W
W       W  WW    WWWW#WWWWWWWW    WWW   WWWW # WWW  WWWW       W
WW WWWW   WW   WWWWW    WWW   WWWWW W W WW   WWW WWWW WWWWW WWWW
WW WW   WWWWW      WW W W   W  #      W    W           WW   WWWW
WWW   WWWW    WW W    W   WWWWWWWW  W WWWWWWWW WWWW WW    W    W
W   WWWWW  W W    WWW WWWWW     WWWWW    WWW    WW  WWWW WWWWW W
W W  WW # WWWW#WW WWW   #   W W     WWWW     WW WW WWW       W W
W WW    WWWWW    WWW  W WWW WWWWW W  WWWW WW WW    WW  WWWWW WWW
W   WWWWW WW  WW     WW WW       WWW     WWW WWWWW    WWWW   # W
W  WWW    WW WWW WW WWWWW   WWW#WWWWW W WWW    WW  WWWW  W WWWWW
W WW   WW    WWWWW    WW  W WWW  W WWWW     WW#WWW W WW WW    WW
W    WWW  WWWWW  # WW                W    WWW           WWWWW#WW
W#WW WWWWWWW    WWW WWWWW     A      WWWWWW   WW WW WWW    WW WW
W WW    W    WWWW                     WW    WWWWWWW  WW WW    WW
W  WWWW   WWWW WWW WWW WW    WWW#WWWW    WW W      WW   WWWWW WW
WW W W  WWW     WWWW   WWWWW       WWWWWWWW   WWWW    WWWW     W
WW      WWW W W W WWW WWW  WW WW W       WWWWWW    WWWW  #  WW W
WWW#W W W   WWW         #  WWWWW WWW W W   W WW WWWW     WWWW  W
WW   WW   WWWW   WWWWW  WWWW     WWW#WWWWW   WW WW    WWWWW   WW
W  WWWW WW   WWW WWWWWW WW   WW WWW    WW  W       WWW   W  WWWW
WW  WWW    WWWW#     WWWWW WWWW W WW  WWW WWWWW WW  WWW    WW WW
W    WWWWW      W WW       WW      WWWWW    WWW  WW   WWWW     W
W WW    WWWW WWWW WWWWW WWWWW  W  WWWW   WW  WWW #WWW  WW  WW WW
W   WWW      WWWW       WW WW#WWW WW   W  WW   WW W  W  WWW   WW
W W WWWWWW WWWW   W WWWWW     WWW    WWWWWWWWW  WWW WWW   WWW WW
W W WWW         WWW   WWW W WWWWWWWWWWWW #     WW   WWWW  WWW  W
W       WWWWW WWW WW    WW    WWWW    W  W WW WWW W  WWW       W
W               W  #    WWW W      WW   WW        WW           W
W       WW W       W     W    W           W WWWW W   WWW       W
WWWWWWWWWWWWWWWWWWWWWWWWWWWWWWWWWWWWWWWWWWWWWWWWWWWWWWWWWWWWWWWW
